..........
.2.......3
..#.......
..#.......
..A.......
..........
..........
..........
..........
..........
